╭─────────────╮┌─────────────┐          
│A            ││Right        │          
│             ││             │          
│             ││             │          
│B            ││             │          
│             ││             │          
│             ││             │          
╰─────────────╯└─────────────┘          